15 15 15 15 16 15 16 15 15 15 15 15 16 15 15 16 29 19 19 19 19 19 19 19 19 19 19 19 19 19 19 19 19 19 19 19 19 19 19 19 19 19 19 19 19 19 19 19 19 19 
15 16 15 15 15 15 15 15 15 16 15 15 15 15 15 15 29 19 19 19 19 19 19 19 19 19 19 19 19 19 19 19 19 19 19 19 19 19 19 19 19 19 19 19 19 19 19 19 19 19 
15 15 15 15 15 15 16 15 15 15 15 15 15 15 16 15 29 19 19 19 35 10 10 10 10 35 10 19 19 19 19 19 19 19 19 19 19 19 19 19 19 19 19 19 19 19 19 19 19 19 
15 15 16 15 15 15 15 16 15 15 15 15 15 15 15 15 29 19 19 19 35 25 28 28 28 26 10 19 19 19 19 19 19 19 19 19 19 19 19 19 19 19 19 19 19 19 19 19 19 19 
15 15 15 15 15 15 16 15 15 15 16 15 15 16 15 15 29 19 19 19 10 30 15 16 15 29 35 19 19 19 19 19 19 19 19 19 19 19 19 19 19 19 19 19 19 19 19 19 19 19 
15 15 15 15 15 16 15 33 27 27 27 27 27 27 27 27 24 19 19 19 10 23 27 27 27 24 10 19 19 19 19 19 19 19 19 19 19 19 19 19 19 19 19 19 19 19 19 19 19 19 
15 16 15 15 15 15 15 29 22 22 22 22 22 19 19 19 19 19 19 19 19 35 10 10 10 10 19 19 19 19 19 19 19 19 19 19 19 19 19 19 19 19 19 19 19 19 19 19 19 19 
15 15 15 15 15 16 15 29 22 37 37 37 22 19 19 19 19 19 19 19 35 10 10 10 35 10 35 19 19 19 19 19 19 10 10 10 35 10 10 10 35 19 19 19 19 19 19 19 19 19 
15 15 15 16 15 15 16 29 22 37 37 37 22 19 19 19 19 19 19 19 19 35 10 35 10 10 19 19 19 19 19 19 19 19 35 10 10 36 10 10 10 10 19 19 19 19 19 19 19 19 
15 15 15 15 15 15 15 29 22 37 37 37 22 19 19 19 19 19 19 19 19 19 10 10 10 19 19 19 19 19 19 19 19 19 10 10 10 35 10 35 10 10 19 19 19 19 19 19 19 19 
15 16 15 15 15 15 15 29 22 37 37 37 22 19 19 19 19 19 19 19 19 19 19 35 19 19 19 19 19 19 19 19 19 19 10 36 10 10 10 10 10 35 19 19 19 19 19 19 19 19 
15 15 15 15 15 16 15 29 22 22 37 22 22 19 19 19 19 19 19 19 19 19 19 10 19 19 19 19 19 19 19 19 19 19 35 10 10 10 10 35 36 10 19 19 19 19 19 19 19 19 
15 15 16 15 15 15 15 29 19 19 35 19 19 19 19 19 19 19 19 19 42 35 10 35 19 19 19 19 19 19 19 19 19 19 19 10 10 35 10 10 10 19 19 19 19 19 19 19 19 19 
15 15 15 15 15 16 15 29 42 35 10 19 19 19 19 19 19 19 19 19 19 19 19 10 19 19 19 19 19 19 19 19 19 19 19 19 19 19 10 19 19 19 19 19 19 19 19 19 19 19 
15 15 16 15 15 15 15 29 19 19 10 19 19 19 19 19 19 19 19 19 19 10 35 10 19 19 19 19 19 19 19 19 19 19 19 19 19 19 35 19 19 19 19 19 19 19 19 19 19 19 
15 16 15 15 16 15 15 29 19 19 35 19 19 19 19 19 19 19 19 19 19 10 19 19 19 19 19 19 19 19 19 19 19 19 19 19 19 19 10 19 19 19 19 19 19 19 19 19 19 19 
15 15 15 15 15 15 16 29 10 35 35 19 19 19 19 19 19 19 19 19 19 35 10 35 19 19 19 19 19 19 19 19 19 19 19 19 19 19 10 19 19 19 19 19 19 19 19 19 19 19 
15 16 15 15 15 15 15 29 10 19 19 19 19 19 19 19 19 19 19 19 19 19 19 35 19 19 19 19 19 19 19 19 19 19 19 19 19 19 10 19 19 19 19 19 19 19 19 19 19 19 
16 15 15 15 16 15 15 29 35 19 19 19 19 19 19 19 19 19 19 19 19 19 35 10 10 19 19 19 19 10 19 19 19 19 19 19 10 35 10 19 19 19 19 19 19 19 19 19 19 19 
15 15 16 15 15 15 15 29 10 19 19 19 19 19 19 19 19 19 19 19 19 35 10 10 10 10 19 19 19 10 19 19 19 19 19 19 10 19 19 19 19 19 19 19 19 19 19 19 19 19 
15 15 15 15 15 16 15 29 10 19 19 19 19 19 19 19 19 19 19 19 10 10 10 35 10 35 10 19 19 10 19 19 19 19 19 10 10 19 19 19 19 19 19 19 19 19 19 19 19 19 
15 15 15 15 15 15 15 29 10 19 19 19 10 35 10 10 35 10 35 10 10 10 10 10 10 10 10 10 10 35 10 35 10 35 10 10 35 19 19 19 19 19 19 19 19 19 19 19 19 19 
15 15 16 15 16 15 15 29 10 19 19 19 35 19 19 19 19 19 19 19 35 10 10 35 10 35 10 19 19 19 19 19 19 19 19 19 10 19 19 19 19 19 19 19 19 19 19 19 19 19 
15 15 15 15 15 15 16 29 35 19 19 19 10 19 19 19 19 19 19 19 19 10 35 10 10 10 19 19 19 19 19 19 19 19 19 19 10 19 19 19 19 19 19 19 19 19 19 19 19 19 
15 15 15 16 15 15 15 29 35 19 19 19 10 19 19 19 19 19 19 19 19 19 10 10 10 19 19 19 19 19 19 19 19 19 19 19 10 19 19 19 19 19 19 19 19 19 19 19 19 19 
15 16 15 15 15 15 15 29 35 19 19 19 10 10 10 19 19 19 19 19 19 19 19 36 19 19 19 19 19 19 19 19 19 19 19 19 35 19 19 19 19 19 19 19 19 19 19 19 19 19 
15 15 15 15 16 15 15 29 10 19 19 19 19 19 10 19 19 19 19 19 19 19 19 36 19 19 19 19 19 19 19 19 19 19 19 19 10 19 19 19 19 19 19 19 19 19 19 19 19 19 
15 15 15 15 15 16 15 29 10 19 19 19 19 19 10 19 19 19 19 19 19 19 19 36 19 19 19 35 19 19 19 19 19 19 19 35 10 19 19 19 19 19 19 19 19 19 19 19 19 19 
15 15 15 15 15 15 15 29 35 19 19 19 19 19 10 19 19 19 19 19 19 19 19 10 19 19 19 19 19 19 10 19 19 19 19 19 10 19 19 19 19 19 19 19 19 19 19 19 19 19 
15 16 15 16 15 15 16 29 10 10 10 10 10 10 10 19 19 19 19 19 19 19 19 35 19 19 19 19 19 19 35 19 19 19 19 19 10 19 19 19 19 19 19 19 19 19 19 19 19 19 
15 15 15 15 16 15 15 29 10 10 35 10 10 35 35 19 19 19 19 19 19 19 19 10 19 19 19 19 19 19 19 19 19 19 19 19 35 19 19 19 19 19 19 19 19 19 19 19 19 19 
15 16 15 15 15 15 15 29 35 10 10 10 10 10 10 19 19 19 19 19 19 19 19 35 19 19 19 19 19 19 19 19 19 19 19 10 35 10 19 19 19 19 19 19 19 19 19 19 19 19 
15 15 15 15 15 16 15 29 10 10 35 10 10 35 10 19 19 19 19 19 19 19 19 35 19 19 19 19 19 19 19 19 19 19 19 10 10 10 19 19 19 19 19 19 19 19 19 19 19 19 
15 15 16 15 16 15 15 29 10 35 10 10 10 10 10 19 19 19 19 19 19 19 19 36 19 19 19 19 19 19 19 19 19 19 19 35 10 10 19 19 19 19 19 19 19 19 19 19 19 19 
15 16 15 15 15 15 15 29 10 10 10 10 35 10 35 19 19 19 19 19 19 19 19 36 19 19 19 19 19 19 19 19 19 19 19 10 10 10 19 19 19 19 19 19 19 19 19 19 19 19 
15 15 15 15 15 16 15 29 19 19 19 19 19 19 19 19 19 19 19 19 19 19 19 36 19 19 19 19 19 19 19 19 19 19 19 10 10 35 19 19 19 19 19 19 19 19 19 19 19 19 
15 15 15 15 15 15 16 29 19 19 19 19 19 19 19 19 19 19 19 10 35 10 35 10 35 10 10 19 19 19 19 19 19 19 10 10 10 10 10 19 19 19 19 19 19 19 19 19 19 19 
15 15 15 16 15 15 15 29 19 19 19 19 19 19 19 19 19 19 35 10 35 10 10 35 10 10 10 10 19 19 10 19 19 10 10 35 10 10 10 19 19 19 19 19 19 19 19 19 19 19 
15 15 16 15 15 15 15 29 19 19 19 19 19 39 19 19 19 19 10 35 10 10 35 10 35 10 35 10 19 19 19 19 10 10 10 10 10 10 10 19 19 19 19 19 19 19 19 19 19 19 
15 16 15 15 15 15 15 29 19 19 19 19 19 10 19 19 19 19 10 10 10 10 10 10 10 10 10 10 10 19 19 19 35 10 10 10 10 19 10 19 19 19 19 19 19 19 19 19 19 19 
15 15 15 15 15 16 15 29 19 19 19 19 19 36 36 36 36 36 10 35 10 10 10 10 10 10 10 10 10 10 35 10 10 10 19 10 35 10 10 19 19 19 19 19 19 19 19 19 19 19 
15 15 16 15 15 15 15 29 19 19 19 19 19 19 19 19 19 19 19 10 10 10 10 10 10 10 10 19 19 19 19 10 10 35 10 10 10 10 36 19 19 19 19 19 19 19 19 19 19 19 
15 15 15 15 16 15 15 29 19 19 19 19 19 42 10 35 10 10 10 10 35 35 10 10 10 10 19 19 19 19 19 35 10 19 10 10 19 36 10 36 36 35 10 10 10 35 35 10 42 19
15 15 15 15 15 15 16 31 28 28 28 28 28 28 28 28 28 28 28 28 28 28 28 28 28 28 28 28 28 28 28 28 28 28 28 28 28 28 28 28 28 28 28 28 28 28 28 28 28 28 
15 16 15 16 15 16 15 15 15 15 15 15 15 15 15 15 15 15 15 16 15 15 15 15 15 15 15 15 15 16 15 15 15 15 15 15 15 15 15 15 15 15 15 16 15 15 15 15 15 16 
16 15 15 16 15 15 15 15 15 15 15 16 15 15 15 15 15 15 15 15 15 15 15 16 15 15 15 16 15 15 15 15 16 15 15 15 16 15 15 16 15 16 15 15 15 15 16 15 15 15 
15 15 15 15 15 15 15 16 15 15 15 15 15 15 15 15 15 15 15 15 15 16 15 15 15 15 15 15 15 15 15 15 15 15 15 15 15 15 15 15 15 15 15 15 15 15 15 15 15 15 
15 15 16 15 15 15 15 15 15 15 16 15 15 15 15 15 15 15 16 15 15 15 15 15 15 15 16 15 15 15 15 15 16 15 15 15 15 15 16 15 15 16 15 15 15 15 15 15 15 15 
15 15 15 15 15 16 15 15 15 15 15 15 15 15 15 16 15 15 15 15 15 15 15 15 16 15 15 15 15 15 15 15 15 15 15 16 15 15 15 15 15 15 15 16 15 15 15 15 16 15 
16 15 15 15 15 15 15 15 16 15 15 15 15 15 15 15 15 16 15 15 15 16 15 15 15 15 15 15 16 15 15 15 15 15 15 15 15 15 15 15 15 15 15 15 15 15 16 15 15 16 